######################
#....................#
#.####################
#....................#
##.#.##.###.##########
##...#...#...........#
#######.###.##########
######################