######################
#......s.............#
#....................#
##.#.##.###.##########
##...#...#...........#
#######v###.##########
######################