############
##.........#
#^........v#
######.....#
############