############
##.......###
#^.......###
######.....#
############